1 1 3 3 3 3 3 1 1 4 3 3 3 3
3 3 1 3 3 3 1 1 3 6 6 5 5 5
3 3 6 1 6 1 1 1 1 4 3 5 3 3
4 3 6 4 6 3 3 1 1 1 3 5 3 3
4 5 5 5 5 5 3 3 4 1 3 3 3 3
5 2 1 1 1 5 3 3 3 3 3 3 3 2
2 2 1 5 1 5 3 3 5 5 3 2 2 2
2 2 1 5 1 5 3 3 5 4 2 2 2 2
2 1 5 5 5 5 5 5 2 2 2 2 7 7
1 1 1 2 2 3 3 3 2 7 7 7 7 7

