3 3 1 5 5 5 5 5 5 5 5 3 4 3 
3 3 3 1 1 6 6 6 6 5 3 3 3 3 
3 3 2 2 6 7 7 7 7 7 7 3 3 3 
3 3 2 6 7 7 7 7 7 6 3 3 3 1 
3 2 7 7 7 7 7 7 7 7 3 4 3 1 
3 2 7 7 7 7 7 7 7 7 5 3 1 1 
2 2 5 6 7 7 7 7 7 7 7 3 4 1 
2 2 2 5 6 7 7 7 6 6 5 3 3 3 
2 3 3 3 5 6 6 6 3 3 3 3 3 1 
3 3 3 1 1 5 5 3 3 3 3 3 3 1 

