3 1 1 5 2 7 7 7 7 2 5 1 1 3 
3 3 1 6 5 2 7 7 7 2 5 1 3 3 
3 4 1 5 5 2 7 7 7 2 5 1 4 3 
3 1 1 5 2 7 7 7 7 2 6 1 3 3 
3 1 1 5 2 7 7 7 7 2 5 1 1 3 
3 1 1 5 2 7 7 7 7 2 5 1 1 3 
3 3 1 6 2 7 7 7 7 2 6 1 1 3 
4 3 1 5 2 7 7 7 7 2 6 1 3 3 
3 3 1 5 2 7 7 7 2 2 5 1 3 3 
3 1 1 6 2 7 7 7 2 5 5 1 3 4 
