7 4 2 2 2 2 5 2 5 2 2 2 4 7 
7 7 4 2 2 2 2 2 2 2 2 4 7 7 
7 7 7 4 1 6 1 1 1 6 1 7 7 7 
4 7 7 4 1 5 1 3 1 5 1 7 7 4 
2 4 7 7 1 6 5 7 5 6 1 7 4 2 
2 4 7 7 1 5 1 3 1 5 1 4 2 2 
2 2 4 4 1 6 1 1 1 6 1 2 2 2 
3 3 2 2 2 2 2 2 2 2 2 2 3 3 
2 3 6 3 3 2 5 3 5 3 3 3 6 3 
2 2 3 3 3 4 3 3 3 3 4 3 3 3 
