1 1 3 3 5 5 7 7 7 7 3 1 1 7
1 4 4 3 5 7 7 7 7 2 3 3 2 7
1 3 3 3 3 3 7 7 2 3 3 3 3 2
7 2 3 3 3 3 3 3 3 3 2 2 2 2
7 7 2 7 2 3 3 3 2 2 7 7 7 7
7 7 7 7 7 7 2 2 2 7 7 5 5 7
6 6 5 3 3 2 2 2 2 2 1 1 3 3
3 3 3 3 4 5 2 7 5 1 1 3 3 3
2 3 3 3 3 6 7 7 7 5 3 4 3 4
7 2 2 2 6 7 7 7 7 7 3 1 1 1
