1 1 5 1 1 1 6 2 2 2 1 5 5 1 
1 1 5 5 1 1 6 2 2 2 1 6 5 1 
5 5 5 5 5 5 6 5 5 5 5 6 1 1 
1 6 1 5 5 1 2 2 2 2 2 6 2 2 
1 6 1 5 2 2 2 2 2 2 2 6 6 5 
6 6 1 1 1 2 2 2 2 2 2 2 2 5 
1 1 2 5 5 5 2 2 5 6 6 2 5 5 
1 2 2 6 5 2 2 2 2 2 6 2 2 2 
2 2 5 6 3 3 2 2 2 2 5 2 2 2 
2 5 5 5 3 3 3 3 2 2 5 2 2 2 

